{
  "年": "年",
  "六": "六",
  "金": "金",
  "聯": "聯",
  "暴": "暴",
  "列": "列",
  "擄": "擄",
  "掠": "掠",
  "臨": "臨",
  "女": "女",
  "諾": "諾",
  "老": "老",
  "不": "不",
  "勒": "勒",
  "賈": "賈",
  "留": "留",
  "律": "律",
  "戀": "戀",
  "什": "什",
  "禮": "禮",
  "略": "略",
  "匿": "匿",
  "念": "念",
  "糧": "糧",
  "隸": "隸",
  "瑩": "瑩",
  "車": "車",
  "雷": "雷",
  "行": "行",
  "陸": "陸",
  "路": "路",
  "賂": "賂",
  "連": "連",
  "靈": "靈",
  "錄": "錄",
  "藍": "藍",
  "綠": "綠",
  "爛": "爛",
  "流": "流",
  "論": "論",
  "離": "離",
  "樂": "樂",
  "利": "利",
  "履": "履",
  "旅": "旅",
  "樂": "樂",
  "領": "領",
  "降": "降",
  "兩": "兩",
  "辰": "辰",
  "便": "便",
  "漏": "漏",
  "力": "力",
  "類": "類",
  "露": "露",
  "累": "累",
  "復": "復",
  "令": "令",
  "廊": "廊",
  "蓮": "蓮",
  "零": "零",
  "狀": "狀",
  "龍": "龍",
  "樓": "樓",
  "參": "參",
  "鍊": "鍊",
  "琉": "琉",
  "理": "理",
  "洞": "洞",
  "凌": "凌",
  "憐": "憐",
  "良": "良",
  "勞": "勞",
  "輦": "輦",
  "嶺": "嶺",
  "硫": "硫",
  "櫓": "櫓",
  "羚": "羚",
  "練": "練",
  "宅": "宅",
  "殮": "殮",
  "朗": "朗",
  "裂": "裂",
  "陋": "陋",
  "洛": "洛",
  "怜": "怜",
  "量": "量",
  "來": "來",
  "裏": "裏",
  "吝": "吝",
  "料": "料",
  "切": "切"
}